10
0222222222220
0222222222220
0222222222220
0260222220620
0122222222220
0111111111110
0111111111110
0111111111110
13x8
