0666666666660
0555555555550
0444444444440
0333333333330
0222222222220
0111111111110
0000001000000
13x7
