000000000000
000110011000
000010010000
000001100000
000001100000